+-----------------------------------------------------------------------------+
! .  .  .  .  .  .  .  .  .  .  .   . ! ! .   .  .  .  .  .  .  .  .  .  .  . !
! . +-------+ . +-----------------+ . ! ! . +-----------------+ . +-------+ . !
! @ !       ! . !                 ! . ! ! . !                 ! . !       ! @ !
! . +-------+ . +-----------------+ . +-+ . +-----------------+ . +-------+ . !
! .  .  .  .  .  .  .  .  .  .  .   .  .  .   .  .  .  .  .  .  .  .  .  .  . !
! . +-------+ . +-------+ . +---------------------+ . +-------+ . +-------+ . !
! . !       ! . !       ! .  .  .   . ! ! .   .  .  . !       ! . !       ! . !
! . !       ! . !       +---------+ . +-+ . +---------+       ! . +-------+ . !
! . +-------+ . !             !                 !             ! .  .  .  .  . !
! .  .  .  .  . !             !   +--+ + +--+   +-------------+ . +-----------+-
+-----------+ . +-------------+   !         !                   .
              .                   !         !   +-------------+ . +-----------+-
+-----------+ . +-------------+   +---------+   !             ! .  .  . +-----!
! .  .  .  .  . !             !                 !             ! . +-+ .  .  . !
! . +-------+ . +-------------+   ===========   +-------------+ . ! !-----+ . !
! @  .  . ! ! .  .  .  .  .  .  .   .     .   .  .  .  .  .  .  . ! ! .  .  @ !
!-----+ . +-+ . +-------+ . +---------------------+ . +-------+ . +-+ . +-----!
! .  .  .  .  . !       ! . !                     ! . !       ! .  .  .  .  . !
! . +-----------+       ! . +---------! !---------+ . !       +-----------+ . !
! . !                   ! .  .  .   . ! ! .   .  .  . !                   ! . !
! . +-----------------------------+ . +-+ . +-----------------------------+ . !
! .  .  .  .  .  .  .  .  .  .  .   .  .  .   .  .  .  .  .  .  .  .  .  .  . !
+-----------------------------------------------------------------------------+