+-----------------------------------------------------------------------------+
! .  .  .  .  .  .  .  .  .  .  .   .  .  .   .  .  .  .  .  .  .  .  .  .  . !
! . +-+ . +-+ . +-----------------+ . +-+ . +-----+ . +-------+ . +-------+ . !
! @ ! ! . ! ! . !                 ! . ! ! . !     ! . !       ! . !       ! @ !
! . +-+ . +-+ . +-----------------+ . +-+ . +-----+ . +-------+ . +-------+ . !
! .  .  .  .  .  .  .  .  .  .  .   .  .  .   .  .  .  .  .  .  .  .  .  .  . !
! . +-------+ . +---------------------------------+ . +---+ . +-----------+ . !
! .  .  .  .  . ! .  .  . .  .  .   . ! ! .   .  .  . !   ! . ! .  .  . . ! . !
! . +-------+ . ! . +-------------+ . +-+ . +---------+---+ . ! . +---+ . + . !
! . +-------+ . ! . ! . . . . !                  .  .  .  . . ! .  .  .  .  . !
! .  .  .  .  . ! .   . +-+ . !   +--+ + +--+   +-------------+ . +-----------+-
+-----------+ . +-------+-+ . !   !         !                   .
                            . !   !         !   +-------+-+ . + . +-----------+-
+-------+   +-------------+ . !   +---------+   ! . . . +-+ . ! .  .  . +-----!
! .  .  .  .  . !   .  .  . . !                 ! . + .   . . ! . +-+ .  .  . !
! . +-------+ . +-------------+   ===========   + . +---------+ . ! !-----+ . !
! @  .  . ! ! .  .  .  .  .  .  .   .     .   .  .  .  .  .  .  . ! ! .  .  @ !
!-----+ . +-+ . +-------+ . +---------------------+ . +---+ . +---+-+ . +-----!
! .  .  .  .  . !       ! . !                     ! . !   ! . ! .  .  .  .  . !
! . +-------+ . +-------+ . +---------! !---------+ . !   ! . +-----------+ . !
! . !       ! .  .  .  .  .  .  .   . ! ! .   .  .  . !   ! .   .  .  .  .  . !
! . +-------+ . +-----------------+ . +-+ . +-------------+---------------+ . !
! .  .  .  .  .  .  .  .  .  .  .   .  .  .   .  .  .  .  .  .  .  .  .  .  . !
+-----------------------------------------------------------------------------+