+-----------------------------------------------------------------------------+
! .  .  .  .  .  .  .  .  .  .  .   .  .  .   .  .  . ! ! .  .  .  .  .  .  . !
! . +-+ . +-----------------------+ . +-+ . +-----+ . +-+ . +-+ . +-------+ . !
! . ! ! . !                       ! .  .  . !     ! .  .  . ! ! . !       ! . !
! . +-+ . +-----------------+     +---------+     +--+ . +--+ ! . +-------+ . !
! @  .  .  .  .  .  .  .  . !                        ! . !    ! .  .  .  .  . !
! . +-+ . +-------------+ . +---------+ +------------+ . +--+-!-----+ . +-+ . !
! . ! ! .  .  .  .  . ! ! .  .  .   . ! ! .   .  .  .  .  . ! ! .  .  . ! ! . !
! . ! +-----------+ . ! +---------+ . +-+ . +-----------+ . ! ! . +-------+ . !
! . +-------------+ . !       !                 !       ! . ! ! @  .  .  .  . !
! .  .  .  .  .  .  . !       !   +--+ + +--+   +-------+ . +-------------+ . +-
+-----------------+ . +-------+   !         !             .      
                                  !         !   +-------+ . +-----------------+-
+ . +-------------+ . +-------+   +---------+   !       ! .  .  .  .  .  .  . !
! .  .  .  .  @ ! ! . !       !                 !       ! . +-------------+ . !
! . +-------+ . ! ! . +-------+   ===========   +-----+ ! . +-----------+ ! . !
! . ! ! .  .  . ! ! .  .  .  .  .   .     .   .  .  . ! ! .  .  .  .  . ! ! . !
! . +-+ . +-----+-+--+ . +------------------------+ . +-------------+ . +-+ . !
! .  .  .  .  . !    ! . !                        ! .  .  .  .  .  .  .  .  @ !
! . +-------+ . ! +--+ . +--+     +---------+     +-----------------+ . +-+ . !
! . !       ! . ! ! .  .  . !     ! .  .  . !                       ! . ! ! . !
! . +-------+ . +-+ . +-+ . +-----+ . +-+ . +-----------------------+ . +-+ . !
! .  .  .  .  .  .  . ! ! .  .  .   .  .  .   .  .  .  .  .  .  .  .  .  .  . !
+-----------------------------------------------------------------------------+